#####
# 1 #
#$$$#
#000##
#    #
#    #
######