######
#   $#
# ## ##
# 001#
# #   #
#$  ###
#####