     ###
######1##
#    *$ #
#   #   #
#####0# #
    #   #
    #####