 ####
 #  ####
 #     ##
## ##   #
#$ $# 1##
#   # 00 #
#  $#    #
##########