####
#  ####
# $ $ #
# 00#1#
##    #
 ######