###### #####
#    ###   #
# 00     #1#
# 0 #$$$   #
#   ########
#####