# #####
  #   #
###001#
#   ###
#     #
# $ $ #
#######