######
#    #
# #1 #
# 0* #
# $* #
#    #
######