####
#  ###
# 00 #
#$$$ #
# 10 #
#   ##
#####