##########
# $#######
#  #######
#*1  #####
#  0 #####
#  #######
##########
##########
##########
##########