 #######
 #     #
 # $0$ #
## 010 #
#  $0$ #
#      #
########