#####
#$  ##
#100 #
##   #
 ##  #
  ##$
   ###