#######
#  *  #
#     #
## # ##
 #01$#
 #   #
 #####