 ####
 #  ###
 # 00 #
##$$$ #
# 10 #
#   ###
#####