#####
#   ###
#$ $  #
#   # #
## #  #
 #100 #
 #    #
 #  ###
 ####