 #####
 # 1 #
 #   #
###0 #
# $$$#
# 00 #
###  #
  ####