########
#      #
# $**01#
#      #
#####  #
    ####