#######
#     #
# # # #
#$ 0*1#
#   ###
#####